___________________________________________________________________________________________________
_XXXXXXXX_XXXXXXXXXXX_X_XXXXXXXXXXXXXXXXXXXXXXXXXXXX_XXXXXXX_XXXXXXXXXXXX_XXXXXXXXXXXX_XXXXXXXXXXX_
_XXX_XXXX_XXXXXXXXXXX_X_XXXXXXXXXXXXXXXXXXXXXXXXXXXX_XXXXXXX_XXXXXXXXXXXX_XXXXXXXXXXXX_XXXXXXXXXXX_
______________________X_XXXXXXXXXXXXXXXXXXXXXXXXXXXX_________XXXXXXXXXXXX_XXXXXXXXXXXX_____________
_XXXX_XXX_XXXXXXXXXXX_X_XXX________________________XXXXXXXXXXX____________XXXXXXXXXXXX_XXXXXX_XXXX_
_XXXXXXXX_____________X_XXX_XXXXXXXXXX_XXXXXXXXXXX_XXXXXXXXXXX_XXXXX_XXXXXXX_____________XXXX__XXX_
_XXXX_X___XXXX_XXXXXXXX_XXX_XXXXXXXXXX_XXXXXXXXXXX_XXXXXXXXXXX_XXXXX_XXXXXXX_XXXX_XXXXXX_XXXXX_XXX_
_XXXX_X_X_______________XXX_XXXXXXXXXX_XXXXXXXXXXX_XXXXXXXXXXX_XXXXX_XXXXXXX_XXXX________XXXXX_XXX_
_XXXX_X___XXXXXXXXXX_XXXXXX____________XXXXXXXXXXX______XXXXXX__XXXX_XXXXXXX_XXXXXXXXXXX_XXXXX_XXX_
________XXXXXXXXXXXX________XXXXXXXXXX_____________XXXX_XXXXXXX____________________________________
_XXXXXXXXXXXXXXXXXXXXXXX_XXXXXXXXXXXXXXXXX_XXXX_XXXXXXX_XXXXXXXXXXX_XXXXXXXXXXXXXXXX_XXXXXXXXXXXXX_
___________________________________________________________________________________________________
_XXXXXXXX_XXXXXXXXXXX_X_XXXXXXXXXXXXXXXXXXXXXXXXXXXX_XXXXXXX_XXXXXXXXXXXX_XXXXXXXXXXXX_XXXXXXXXXXX_
_XXX_XXXX_XXXXXXXXXXX_X_XXXXXXXXXXXXXXXXXXXXXXXXXXXX_XXXXXXX_XXXXXXXXXXXX_XXXXXXXXXXXX_XXXXXXXXXXX_
______________________X_XXXXXXXXXXXXXXXXXXXXXXXXXXXX_________XXXXXXXXXXXX_XXXXXXXXXXXX_____________
_XXXX_XXX_XXXXXXXXXXX_X_XXX________________________XXXXXXXXXXX____________XXXXXXXXXXXX_XXXXXX_XXXX_
_XXXXXXXX_____________X_XXX_XXXXXXXXXX_XXXXXXXXXXX_XXXXXXXXXXX_XXXXX_XXXXXXX_____________XXXX__XXX_
_XXXX_X___XXXX_XXXXXXXX_XXX_XXXXXXXXXX_XXXXXXXXXXX_XXXXXXXXXXX_XXXXX_XXXXXXX_XXXX_XXXXXX_XXXXX_XXX_
_XXXX_X_X_______________XXX_XXXXXXXXXX_XXXXXXXXXXX_XXXXXXXXXXX_XXXXX_XXXXXXX_XXXX________XXXXX_XXX_
_XXXX_X___XXXXXXXXXX_XXXXXX____________XXXXXXXXXXX______XXXXXX__XXXX_XXXXXXX_XXXXXXXXXXX_XXXXX_XXX_
________XXXXXXXXXXXX________XXXXXXXXXX_____________XXXX_XXXXXXX____________________________________
_XXXXXXXXXXXXXXXXXXXXXXX_XXXXXXXXXXXXXXXXX_XXXX_XXXXXXX_XXXXXXXXXXX_XXXXXXXXXXXXXXXX_XXXXXXXXXXXXX_
___________________________________________________________________________________________________
_XXXXXXXX_XXXXXXXXXXX_X_XXXXXXXXXXXXXXXXXXXXXXXXXXXX_XXXXXXX_XXXXXXXXXXXX_XXXXXXXXXXXX_XXXXXXXXXXX_
_XXX_XXXX_XXXXXXXXXXX_X_XXXXXXXXXXXXXXXXXXXXXXXXXXXX_XXXXXXX_XXXXXXXXXXXX_XXXXXXXXXXXX_XXXXXXXXXXX_
______________________X_XXXXXXXXXXXXXXXXXXXXXXXXXXXX_________XXXXXXXXXXXX_XXXXXXXXXXXX_____________
_XXXX_XXX_XXXXXXXXXXX_X_XXX________________________XXXXXXXXXXX____________XXXXXXXXXXXX_XXXXXX_XXXX_
_XXXXXXXX_____________X_XXX_XXXXXXXXXX_XXXXXXXXXXX_XXXXXXXXXXX_XXXXX_XXXXXXX_____________XXXX__XXX_
_XXXX_X___XXXX_XXXXXXXX_XXX_XXXXXXXXXX_XXXXXXXXXXX_XXXXXXXXXXX_XXXXX_XXXXXXX_XXXX_XXXXXX_XXXXX_XXX_
_XXXX_X_X_______________XXX_XXXXXXXXXX_XXXXXXXXXXX_XXXXXXXXXXX_XXXXX_XXXXXXX_XXXX________XXXXX_XXX_
_XXXX_X___XXXXXXXXXX_XXXXXX____________XXXXXXXXXXX______XXXXXX__XXXX_XXXXXXX_XXXXXXXXXXX_XXXXX_XXX_
________XXXXXXXXXXXX________XXXXXXXXXX_____________XXXX_XXXXXXX____________________________________
_XXXXXXXXXXXXXXXXXXXXXXX_XXXXXXXXXXXXXXXXX_XXXX_XXXXXXX_XXXXXXXXXXX_XXXXXXXXXXXXXXXX_XXXXXXXXXXXXX_
___________________________________________________________________________________________________
_XXXXXXXX_XXXXXXXXXXX_X_XXXXXXXXXXXXXXXXXXXXXXXXXXXX_XXXXXXX_XXXXXXXXXXXX_XXXXXXXXXXXX_XXXXXXXXXXX_
_XXX_XXXX_XXXXXXXXXXX_X_XXXXXXXXXXXXXXXXXXXXXXXXXXXX_XXXXXXX_XXXXXXXXXXXX_XXXXXXXXXXXX_XXXXXXXXXXX_
______________________X_XXXXXXXXXXXXXXXXXXXXXXXXXXXX_________XXXXXXXXXXXX_XXXXXXXXXXXX_____________
_XXXX_XXX_XXXXXXXXXXX_X_XXX________________________XXXXXXXXXXX____________XXXXXXXXXXXX_XXXXXX_XXXX_
_XXXXXXXX_____________X_XXX_XXXXXXXXXX_XXXXXXXXXXX_XXXXXXXXXXX_XXXXX_XXXXXXX_____________XXXX__XXX_
_XXXX_X___XXXX_XXXXXXXX_XXX_XXXXXXXXXX_XXXXXXXXXXX_XXXXXXXXXXX_XXXXX_XXXXXXX_XXXX_XXXXXX_XXXXX_XXX_
_XXXX_X_X_______________XXX_XXXXXXXXXX_XXXXXXXXXXX_XXXXXXXXXXX_XXXXX_XXXXXXX_XXXX________XXXXX_XXX_
_XXXX_X___XXXXXXXXXX_XXXXXX____________XXXXXXXXXXX______XXXXXX__XXXX_XXXXXXX_XXXXXXXXXXX_XXXXX_XXX_
________XXXXXXXXXXXX________XXXXXXXXXX_____________XXXX_XXXXXXX____________________________________
_XXXXXXXXXXXXXXXXXXXXXXX_XXXXXXXXXXXXXXXXX_XXXX_XXXXXXX_XXXXXXXXXXX_XXXXXXXXXXXXXXXX_XXXXXXXXXXXXX_
___________________________________________________________________________________________________
_XXXXXXXX_XXXXXXXXXXX_X_XXXXXXXXXXXXXXXXXXXXXXXXXXXX_XXXXXXX_XXXXXXXXXXXX_XXXXXXXXXXXX_XXXXXXXXXXX_
_XXX_XXXX_XXXXXXXXXXX_X_XXXXXXXXXXXXXXXXXXXXXXXXXXXX_XXXXXXX_XXXXXXXXXXXX_XXXXXXXXXXXX_XXXXXXXXXXX_
______________________X_XXXXXXXXXXXXXXXXXXXXXXXXXXXX___________XXXXXXXXXX_XXXXXXXXXXXX_____________
_XXXX_XXX_XXXXXXXXXXX___XXX__________________________XX_XXXXXX____________XXXXXXXXXXXX_XXXXXX_XXXX_
_XXXXXXXXXXXXXXXXXXXXXX_XXXXXXXXXXXXXXXXXX_XXXX_XXXXXXX_XXXXXXXXXXX_XXXXXXXXXXXXXXXXXX_XXXXXXXXXXX_
___________________________________________________________________________________________________
_XXXXXXXX_XXXXXXXXXXX_X_XXXXXXXXXXXXXXXXXXXXXXXXXXXX_XXXXXXX_XXXXXXXXXXXX_XXXXXXXXXXXX_XXXXXXXXXXX_
_XXX_XXXX_XXXXXXXXXXX_X_XXXXXXXXXXXXXXXXXXXXXXXXXXXX_XXXXXXX_XXXXXXXXXXXX_XXXXXXXXXXXX_XXXXXXXXXXX_
______________________X_XXXXXXXXXXXXXXXXXXXXXXXXXXXX_________XXXXXXXXXXXX_XXXXXXXXXXXX_____________
_XXXX_XXX_XXXXXXXXXXX_X_XXX________________________XXXXXXXXXXX____________XXXXXXXXXXXX_XXXXXX_XXXX_
_XXXXXXXXXXXXXXXXXXXXXX_XXXXXXXXXXXXXXXXXX_XXXX_XXXXXXX_XXXXXXXXXXX_XXXXXXXXXXXXXXXXXX_XXXXXXXXXXX_
___________________________________________________________________________________________________
