XXXXXXXXXXXXXXXXXXXXXXXXXXXXXXXXXXXXXXXXXXXXXXXXXX
X__________XXXXXXXX_____XXXXXXX___________XXXXXXXX
X_XXXXXXXX__________XXX_XXXXXXX_XXX_XXXXX________X
X_____XXXXXXXXXXXXX_XXX_XXXXXXX_XXX_XXXXX_XXXXXX_X
X_XXX_XXXXXXXXXXXXX_XXX_XXXXXXX_XXX_XXXXX_XXXXXX_X
X_XXX______XXXXXXXX_XXX_____________XXXXX_XXXXXX_X
X_XXXX_XXX_XXXXXXXX_XXX_XXXXXXXXXXX_XXXXX_XXXXXX_X
X_XXXX_XXX__________XXX_____XXXXXXX_XXXXX________X
X_XXXX_XXX_XXXXXXXX_XXX_XXX_XXXXXXX_XXXXX_XXXXX_XX
X______XXX_XXX________X_XXX_________XXXXX_XXXXX_XX
X_XXXX_XXX_____XXXX_X_X_XXXXX_XXXXX____XX_______XX
X_XXXX_XXX_XXX_XXXX_X_X_XXXXX_XXXXX_XX_XX_XXXXXXXX
X__________XXX_XXXX_X_________XXXXX_XX_XX_XXXXXXXX
X_XXXXXXXX_XXX_XXXX_XXX_XXXXX_XXXXX_XX_XX_XXXXXXXX
X_XXXXXXXX_XXX_XXXX_____XXXXX_XXXXX_XX____XXXXXXXX
X__________XXX_XXXX_XXX_XXXXX_______XXXXX_XXXXXXXX
X_XXXXXXXX_____XXXX_XXX_XXXXX_XXXXX_XXXXX________X
X_XXXXXXXX_XXX______XXX_XXXXX_XXXXX_XXXXX_XXXXXX_X
X_XXXXXXXX_XXX_XXXX_XXX_XXXXX_XXXXX_XXXXX_XXXXXX_X
X__________XXX_XXXX_XXX_XXXXX____________________X
X_XXXXXXXX_____XXXX_XXX_XXXXX_XXXXX_XXXXX_XXXXXX_X
X_XXXXXXXX_XXXXXXXX_XXX_______XXXXX_XXXXX_XXXXXX_X
X_XXXXXXXX__________XXX_XXXXX_XXXXX_XXXXX_XXXXXX_X
X______XXX_XXXXXXXX_XXX_XXXXX_______XXXXX_XXXXXX_X
XXXXXX_XXX_____XXXX_XXX_XXXXX_XXXXX_XXXXX________X
XXXXXX_XXX_XXX_XXXX_XXX_XXXXX_XXXXX_XXXXX_XXXXXX_X
X__________XXX_XXXX_XXX_______XXXXX_______XXXXXX_X
X_XXXXXXXX_XXX______XXX_XXXXX_XXXXX_XXXXX_XXXXXX_X
X_XXXXXXXX_XXX_XXXX_XXX_XXXXX_XXXXX_XXXXX_XXXXXX_X
X__________XXX_XXXX_____XXXXX____________________X
X_XXXXXXXX_____XXXX_XXX_XXXXX_XXXXX_XXXXX_XXXXXX_X
X_XXXXXXXX_XXXXXXXX_XXX_______XXXXX_XXXXX_XXXXXX_X
X_XXXX______________XXX_XXXXX_XXXXX_XXXXX_XXXXXX_X
X______XXX_XXX_XXXX_XXX_XXXXX__________XX_XXXXXX_X
X_XXXX_XXX_XXX_XXXX_XXX_______XXXXX_XX_XX________X
X_XXXX_XXX_XXX_XXXX_____XXXXX_XXXXX_XX____XXXXXXXX
X__________XXX_XXXX_XXX_XXXXX_______XXXXX________X
X_XXXXXXXX_XXX______XXX_XXXXX_XXXXX_XXXXX_XXXXXX_X
X_XXXXXXXX_XXX_XXXX_XXX_XXXXX_XXXXX_XXXXX_XXXXXX_X
X__________XXX_XXXX_XXX_XXXXX____________________X
X_XXXXXXXX_____XXXX_XXX_XXXXX_XXXXX_XXXXX_XXXXXX_X
X_XXXXXXXX_XXXXXXXX_XXX_______XXXXX_______XXXXXX_X
X_XXXXXXXX__________XXXXXXXXX_XXXXX_XXXXX_XXXXXX_X
X__________XXXXXXXX_XXXXXXXXX_______XXXXX_XXXXXX_X
X_XXXXXXXX__________XXXXXX____XXXXX_XXXXX________X
X_XXXXXXXX_XXXXXXXXXXXXXXX_XX_XXXXX_XXXXX_XXXXXX_X
X__________XXXXXX___XXXXXX_XX_XXXXX_______XXXXXX_X
XXXXXXXXXX_XXXXXX_X_XXX____XX_XXXXX_XXXXX_XXXXXX_X
XXXXXXXXXX________X_____XXXXX_______XXXXX________X
XXXXXXXXXXXXXXXXXXXXXXXXXXXXXXXXXXXXXXXXXXXXXXXXXX
